sampleID,poiseid,fu,Final.Library.Conc..nM.,Final.Library.Conc..ng.ul.,sample.name.in.MiniSeq,sample_id,On.Plate,readcount,avglength,uniquely_mapped_reads,uniquely_mapped_Percent,unmapped_reads,mapped_to_others,deteced_TPM.0,detected_coding_TPM.0,detected_noncoding_TPM.0,deteced_TPM.1,detected_coding_TPM.1,detected_noncoding_TPM.1,datespecimen,cancertype,cancerstage_cat,er_cat,pr_cat,her2_cat,chemo,datechemostart,datechemoend,daterecurrence,recurStatus
C1,2006,2,81.01,15.83,ZZ-20170524-Cellfree-10-01,S01_B14,A1,435826,75,370649,85.05%,38396,2036,10813,7442,3371,10813,7442,3371,11/3/09,Ductal,3,0,0,0,AC/T,31/12/2008,8/4/09,29/06/2009,R
C2,2006,3,35.99,7.03,ZZ-20170524-Cellfree-10-02,S02_B14,A2,563731,75,481372,85.39%,46965,3136,11337,7648,3689,11337,7648,3689,17/06/2009,Ductal,3,0,0,0,AC/T,31/12/2008,8/4/09,29/06/2009,R
C3,2010,3,70.89,13.85,ZZ-20170524-Cellfree-10-03,S03_B14,A3,457102,74,399462,87.39%,31019,1979,10601,7179,3422,10601,7179,3422,17/06/2009,Ductal,2,0,0,0,AC/T,7/1/09,20/05/2009,9/11/10,R
C4,2010,4,114.2,22.31,ZZ-20170524-Cellfree-10-04,S04_B14,A4,638280,75,562452,88.12%,37675,2093,13787,8912,4875,13787,8912,4875,13/01/2010,Ductal,2,0,0,0,AC/T,7/1/09,20/05/2009,9/11/10,R
C5,2011,2,108.95,21.28,ZZ-20170524-Cellfree-10-05,S05_B14,A5,434579,75,382854,88.10%,24806,1349,9665,6618,3047,9665,6618,3047,13/04/2009,Ductal,3,1,1,0,AC/T,12/1/09,27/04/2009,22/12/2010,R
C6,2011,3,101.29,19.79,ZZ-20170524-Cellfree-10-06,S06_B14,A6,455242,75,401148,88.12%,26640,1560,10585,7170,3415,10585,7170,3415,30/08/2010,Ductal,3,1,1,0,AC/T,12/1/09,27/04/2009,22/12/2010,R
C7,2011,10,55.6,10.86,ZZ-20170524-Cellfree-10-07,S07_B14,A7,525718,75,457406,87.01%,35170,2200,10776,7239,3537,10776,7239,3537,6/2/13,Ductal,3,1,1,0,AC/T,12/1/09,27/04/2009,22/12/2010,R
C8,2018,2,53.68,10.49,ZZ-20170524-Cellfree-10-08,S08_B14,A8,428201,75,383339,89.52%,20619,1135,9246,6238,3008,9246,6238,3008,2/7/09,Ductal,1,1,0,0,TC,6/3/09,11/5/09,15/06/2011,R
C9,2018,3,147.44,28.8,ZZ-20170524-Cellfree-10-09,S09_B14,A9,387048,75,339741,87.78%,23850,1297,9904,6832,3072,9904,6832,3072,15/09/2009,Ductal,1,1,0,0,TC,6/3/09,11/5/09,15/06/2011,R
C10,2018,4,66.77,13.04,ZZ-20170524-Cellfree-10-10,S10_B14,A10,461969,75,389702,84.36%,44451,2231,10241,7054,3187,10241,7054,3187,22/03/2010,Ductal,1,1,0,0,TC,6/3/09,11/5/09,15/06/2011,R
C11,2018,5,68.17,13.32,ZZ-20170524-Cellfree-10-11,S11_B14,A11,371455,75,324583,87.38%,24275,1627,9250,6423,2827,9250,6423,2827,20/09/2010,Ductal,1,1,0,0,TC,6/3/09,11/5/09,15/06/2011,R
C12,2056,2,79.21,15.47,ZZ-20170524-Cellfree-10-12,S12_B14,A12,466825,75,405853,86.94%,32335,2744,10422,7091,3331,10422,7091,3331,10/8/10,Ductal,1,0,0,0,AC/T,19/05/2010,28/09/2010,6/4/12,R
C13,2056,4,92.19,18.01,ZZ-20170524-Cellfree-10-13,S13_B14,B1,455625,74,391041,85.83%,32596,1918,11867,8025,3842,11867,8025,3842,20/04/2011,Ductal,1,0,0,0,AC/T,19/05/2010,28/09/2010,6/4/12,R
C14,6027,3,68.93,13.47,ZZ-20170524-Cellfree-10-14,S14_B14,B2,359841,75,311949,86.69%,23999,1298,9306,6391,2915,9306,6391,2915,16/12/2011,Ductal,2,0,0,0,AC/T,15/07/2011,18/11/2011,22/08/2012,R
C15,6027,4,85.41,16.69,ZZ-20170524-Cellfree-10-15,S15_B14,B3,379592,75,334548,88.13%,21744,920,10353,7182,3171,10353,7182,3171,24/07/2012,Ductal,2,0,0,0,AC/T,15/07/2011,18/11/2011,22/08/2012,R
C16,6027,5,104.75,20.46,ZZ-20170524-Cellfree-10-16,S16_B14,B4,408420,75,353358,86.52%,28804,2062,9441,6460,2981,9441,6460,2981,14/10/2012,Ductal,2,0,0,0,AC/T,15/07/2011,18/11/2011,22/08/2012,R
C17,6027,2,18.41,3.6,ZZ-20170524-Cellfree-10-17,S17_B14,B5,332636,75,283564,85.25%,28886,2956,7148,4981,2167,7148,4981,2167,16/09/2011,Ductal,2,0,0,0,AC/T,15/07/2011,18/11/2011,22/08/2012,R
C18,6023,3,82.38,16.09,ZZ-20170524-Cellfree-10-18,S18_B14,B6,445285,73,391892,88.01%,29375,2492,9732,6595,3137,9732,6595,3137,14/11/2011,Mixed,2,0,0,0,AC/T,17/06/2011,11/11/11,31/08/2012,R
C19,6023,4,34.3,6.7,ZZ-20170524-Cellfree-10-19,S19_B14,B7,359343,75,311597,86.71%,24262,1199,7693,5313,2380,7693,5313,2380,25/04/2012,Mixed,2,0,0,0,AC/T,17/06/2011,11/11/11,31/08/2012,R
C20,6060,3,103.75,20.27,ZZ-20170524-Cellfree-10-20,S20_B14,B8,367639,75,324306,88.21%,21887,975,9525,6526,2999,9525,6526,2999,4/9/13,Ductal,9,1,1,0,AC/T,8/3/13,19/08/2013,26/02/2014,R
C21,6060,4,123.24,24.08,ZZ-20170524-Cellfree-10-21,S21_B14,B9,470588,75,416907,88.59%,25271,1173,11174,7578,3596,11174,7578,3596,17/01/2014,Ductal,9,1,1,0,AC/T,8/3/13,19/08/2013,26/02/2014,R
C22,6039,3,38.47,7.51,ZZ-20170524-Cellfree-10-22,S22_B14,B10,232963,74,203368,87.30%,15549,1105,6483,4575,1908,6483,4575,1908,10/12/12,Ductal,2,0,0,1,AC/T,13/06/2012,17/10/2012,18/06/2014,R
C23,2011,5,84.26,16.46,ZZ-20170524-Cellfree-10-23,S23_B14,B11,417764,75,360759,86.35%,29425,1797,10359,7070,3289,10359,7070,3289,30/08/2010,Ductal,3,1,1,0,AC/T,12/1/09,27/04/2009,22/12/2010,R
C24,6039,5,40.42,7.9,ZZ-20170524-Cellfree-10-24,S24_B14,B12,403163,75,347945,86.30%,27790,1684,9602,6639,2963,9602,6639,2963,10/3/14,Ductal,2,0,0,1,AC/T,13/06/2012,17/10/2012,18/06/2014,R
C25,6039,2,78.97,15.43,ZZ-20170524-Cellfree-10-25,S25_B14,C1,584723,75,510059,87.23%,37382,1744,13848,9290,4558,13848,9290,4558,29/08/2012,Ductal,2,0,0,1,AC/T,13/06/2012,17/10/2012,18/06/2014,R
C26,6045,4,88.47,17.28,ZZ-20170524-Cellfree-10-26,S26_B14,C2,395510,75,347074,87.75%,24247,1146,10234,7021,3213,10234,7021,3213,21/09/2013,Ductal,2,0,0,1,AC/T,9/8/12,26/12/2012,3/7/14,R
C27,6045,3,79.57,15.54,ZZ-20170524-Cellfree-10-27,S27_B14,C3,412340,75,365693,88.69%,23275,1108,9664,6573,3091,9664,6573,3091,8/8/12,Ductal,2,0,0,1,AC/T,9/8/12,26/12/2012,3/7/14,R
C28,6045,6,105.94,20.69,ZZ-20170524-Cellfree-10-28,S28_B14,C4,456313,75,397286,87.06%,30333,1628,11334,7762,3572,11334,7762,3572,10/9/14,Ductal,2,0,0,1,AC/T,9/8/12,26/12/2012,3/7/14,R
C29,6062,3,13.5,2.64,ZZ-20170524-Cellfree-10-29,S29_B14,C5,378200,74,286043,75.63%,67505,6066,5651,3941,1710,5651,3941,1710,27/11/2013,Ductal,3,1,1,1,AC/T,14/05/2013,29/10/2013,1/3/25,N
C30,6062,4,34.84,6.81,ZZ-20170524-Cellfree-10-30,S30_B14,C6,480696,74,421966,87.78%,31713,1941,10127,6857,3270,10127,6857,3270,14/05/2014,Ductal,3,1,1,1,AC/T,14/05/2013,29/10/2013,1/3/25,N
C31,6057,3,121.13,23.66,ZZ-20170524-Cellfree-10-31,S31_B14,C7,378470,75,337842,89.27%,18523,723,9049,6085,2964,9049,6085,2964,29/07/2013,Ductal,2,1,1,0,AC/T/N,1/5/13,13/06/2013,1/3/25,N
C32,6057,5,35.08,6.85,ZZ-20170524-Cellfree-10-32,S32_B14,C8,472071,74,411536,87.18%,31294,1957,9782,6670,3112,9782,6670,3112,11/6/14,Ductal,2,1,1,0,AC/T/N,1/5/13,13/06/2013,1/3/25,N
C33,6056,2,132.99,25.98,ZZ-20170524-Cellfree-10-33,S33_B14,C9,364565,75,316905,86.93%,24443,1245,10020,6927,3093,10020,6927,3093,4/4/13,Ductal,2,1,1,0,AC/T,27/12/2012,5/4/13,1/3/25,N
C34,6056,3,39.75,7.76,ZZ-20170524-Cellfree-10-34,S34_B14,C10,466487,75,401796,86.13%,37795,2361,10964,7568,3396,10964,7568,3396,24/06/2013,Ductal,2,1,1,0,AC/T,27/12/2012,5/4/13,1/3/25,N
C35,6049,4,113.29,22.13,ZZ-20170524-Cellfree-10-35,S35_B14,C11,406987,75,360910,88.68%,22822,1129,10288,7034,3254,10288,7034,3254,12/11/13,Ductal,2,1,1,0,AC/T,18/10/2012,16/03/2013,1/3/25,N
C36,6049,1,31.01,6.06,ZZ-20170524-Cellfree-10-36,S36_B14,C12,391931,75,335203,85.53%,31275,1996,9264,6421,2843,9264,6421,2843,18/10/2012,Ductal,2,1,1,0,AC/T,18/10/2012,16/03/2013,1/3/25,N
C37,6044,3,127.89,24.98,ZZ-20170524-Cellfree-10-37,S37_B14,D1,438312,75,386581,88.20%,24607,1395,10515,7181,3334,10515,7181,3334,14/01/2013,Ductal,3,0,0,0,AC/T,13/07/2012,2/12/12,1/3/25,N
C38,6044,4,26.17,5.11,ZZ-20170524-Cellfree-10-38,S38_B14,D2,311261,75,271009,87.07%,21568,2196,7343,5239,2104,7343,5239,2104,24/06/2013,Ductal,3,0,0,0,AC/T,13/07/2012,2/12/12,1/3/25,N
C39,6043,3,120.75,23.59,ZZ-20170524-Cellfree-10-39,S39_B14,D3,358483,75,316167,88.20%,20243,737,9520,6566,2954,9520,6566,2954,19/11/2012,Ductal,2,1,1,1,AC/T,8/6/12,24/10/2012,1/3/25,N
C40,6043,4,19.03,3.72,ZZ-20170524-Cellfree-10-40,S40_B14,D4,401435,75,339911,84.67%,36457,3165,8806,6148,2658,8806,6148,2658,24/06/2013,Ductal,2,1,1,1,AC/T,8/6/12,24/10/2012,1/3/25,N
C41,6040,2,130.52,25.5,ZZ-20170524-Cellfree-10-41,S41_B14,D5,362006,74,317589,87.73%,21658,950,9288,6228,3060,9288,6228,3060,6/9/12,Ductal,2,0,0,0,TC,29/05/2012,1/8/12,1/3/25,N
C42,6040,3,107.23,20.95,ZZ-20170524-Cellfree-10-42,S42_B14,D6,444426,74,395264,88.94%,24285,1152,9354,6415,2939,9354,6415,2939,11/12/12,Ductal,2,0,0,0,TC,29/05/2012,1/8/12,1/3/25,N
C43,6038,2,83.41,16.29,ZZ-20170524-Cellfree-10-43,S43_B14,D7,392215,74,341898,87.17%,25674,1924,9177,6230,2947,9177,6230,2947,10/7/12,Ductal,3,1,0,0,AC/T,17/04/2012,31/07/2012,1/3/25,N
C44,6038,5,87.26,17.05,ZZ-20170524-Cellfree-10-44,S44_B14,D8,462835,74,404593,87.42%,29085,1661,10270,7003,3267,10270,7003,3267,6/2/14,Ductal,3,1,0,0,AC/T,17/04/2012,31/07/2012,1/3/25,N
C45,6035,2,113.68,22.21,ZZ-20170524-Cellfree-10-45,S45_B14,D9,452078,74,387101,85.63%,35475,1782,11108,7480,3628,11108,7480,3628,27/06/2012,Ductal,2,1,1,0,TC,25/04/2012,27/06/2012,1/3/25,N
C46,6035,3,115.15,22.49,ZZ-20170524-Cellfree-10-46,S46_B14,D10,438011,75,383918,87.65%,28973,1433,9859,6580,3279,9859,6580,3279,7/12/12,Ductal,2,1,1,0,TC,25/04/2012,27/06/2012,1/3/25,N
C47,6034,2,139.64,27.28,ZZ-20170524-Cellfree-10-47,S47_B14,D11,410346,75,366168,89.23%,20253,798,10465,7030,3435,10465,7030,3435,19/04/2012,Ductal,3,1,0,0,AC/T,11/1/12,19/04/2012,1/3/25,N
C48,6034,3,96.15,18.78,ZZ-20170524-Cellfree-10-48,S48_B14,D12,317697,75,281346,88.56%,18350,850,8434,5814,2620,8434,5814,2620,13/07/2012,Ductal,3,1,0,0,AC/T,11/1/12,19/04/2012,1/3/25,N
C49,6028,2,97.38,19.02,ZZ-20170524-Cellfree-10-49,S49_B14,E1,378510,75,331404,87.55%,25027,1295,9059,6184,2875,9059,6184,2875,21/09/2011,Ductal,2,0,0,0,AC/T,22/06/2011,12/10/11,1/3/25,N
C50,6028,3,98.62,19.27,ZZ-20170524-Cellfree-10-50,S50_B14,E2,392276,74,338938,86.40%,29504,1846,9772,6733,3039,9772,6733,3039,21/03/2012,Ductal,2,0,0,0,AC/T,22/06/2011,12/10/11,1/3/25,N
C51,6025,3,43.34,8.47,ZZ-20170524-Cellfree-10-51,S51_B14,E3,400892,75,356014,88.81%,22885,1071,7845,5366,2479,7845,5366,2479,21/12/2011,Ductal,2,0,0,0,AC/T,14/06/2011,8/11/11,1/3/25,N
C52,6025,4,16.94,3.31,ZZ-20170524-Cellfree-10-52,S52_B14,E4,341512,75,286431,83.87%,34169,4459,6770,4754,2016,6770,4754,2016,21/02/2012,Ductal,2,0,0,0,AC/T,14/06/2011,8/11/11,1/3/25,N
C53,6022,3,16.04,3.13,ZZ-20170524-Cellfree-10-53,S53_B14,E5,291243,74,227278,78.04%,43481,6110,5150,3832,1318,5150,3832,1318,5/10/11,Ductal,2,1,1,1,AC/T,4/5/11,26/10/2011,1/3/25,N
C54,6022,4,39.68,7.75,ZZ-20170524-Cellfree-10-54,S54_B14,E6,462826,74,396520,85.67%,37301,1961,11010,7427,3583,11010,7427,3583,11/4/12,Ductal,2,1,1,1,AC/T,4/5/11,26/10/2011,1/3/25,N
C55,6021,2,127.99,25,ZZ-20170524-Cellfree-10-55,S55_B14,E7,336404,75,298119,88.62%,18475,1097,8307,5710,2597,8307,5710,2597,14/04/2011,Ductal,2,1,1,0,AC/T,10/1/11,25/04/2011,1/3/25,N
C56,6021,3,106.91,20.88,ZZ-20170524-Cellfree-10-56,S56_B14,E8,517215,75,455369,88.04%,30490,1519,11871,8028,3843,11871,8028,3843,18/08/2011,Ductal,2,1,1,0,AC/T,10/1/11,25/04/2011,1/3/25,N
C57,6019,2,69.07,13.49,ZZ-20170524-Cellfree-10-57,S57_B14,E9,456393,74,394362,86.41%,35699,1970,10687,7246,3441,10687,7246,3441,8/6/11,Ductal,3,1,1,0,AC/T,4/3/11,10/6/11,1/3/25,N
C58,6019,3,139.67,27.28,ZZ-20170524-Cellfree-10-58,S58_B14,E10,393420,75,350930,89.20%,21513,867,9311,6311,3000,9311,6311,3000,21/09/2011,Ductal,3,1,1,0,AC/T,4/3/11,10/6/11,1/3/25,N
C59,6017,2,37.58,7.34,ZZ-20170524-Cellfree-10-59,S59_B14,E11,446385,74,366378,82.08%,49544,3277,9410,6551,2859,9410,6551,2859,11/7/11,Ductal,2,1,1,0,AC/T,2/5/11,8/8/11,1/3/25,N
C60,6017,3,26.2,5.12,ZZ-20170524-Cellfree-10-60,S60_B14,E12,401038,74,340876,85.00%,36705,3537,8195,5777,2418,8195,5777,2418,9/1/12,Ductal,2,1,1,0,AC/T,2/5/11,8/8/11,1/3/25,N
C61,2097,2,103.53,20.22,ZZ-20170524-Cellfree-10-61,S61_B14,F1,381085,75,338837,88.91%,20494,832,10013,6803,3210,10013,6803,3210,17/01/2013,Ductal,2,1,1,1,AC/T,11/10/12,17/01/2013,1/3/25,N
C62,2097,3,55.62,10.87,ZZ-20170524-Cellfree-10-62,S62_B14,F2,398566,75,347324,87.14%,27248,1896,9670,6610,3060,9670,6610,3060,2/5/13,Ductal,2,1,1,1,AC/T,11/10/12,17/01/2013,1/3/25,N
C63,2091,2,120.13,23.47,ZZ-20170524-Cellfree-10-63,S63_B14,F3,389287,74,339097,87.11%,24126,816,9873,6612,3261,9873,6612,3261,7/12/11,Ductal,2,1,1,0,AC/T,14/09/2011,23/11/2011,1/3/25,N
C64,2091,5,107.02,20.91,ZZ-20170524-Cellfree-10-64,S64_B14,F4,373433,75,331536,88.78%,20388,942,9114,6172,2942,9114,6172,2942,13/05/2013,Ductal,2,1,1,0,AC/T,14/09/2011,23/11/2011,1/3/25,N
C65,2075,2,153.56,30,ZZ-20170524-Cellfree-10-65,S65_B14,F5,450321,74,394433,87.59%,27030,1193,9808,6606,3202,9808,6606,3202,13/06/2011,Ductal,2,1,1,0,AC,11/4/11,9/5/11,1/3/25,N
C66,2075,3,101.47,19.82,ZZ-20170524-Cellfree-10-66,S66_B14,F6,460468,74,411028,89.26%,25052,1178,10523,7008,3515,10523,7008,3515,22/09/2011,Ductal,2,1,1,0,AC,11/4/11,9/5/11,1/3/25,N
C67,2074,2,25.59,5,ZZ-20170524-Cellfree-10-67,S67_B14,F7,360036,75,317049,88.06%,23555,939,7602,5241,2361,7602,5241,2361,6/7/11,Ductal,2,0,0,1,AC/T,14/02/2011,25/05/2011,1/3/25,N
C68,2074,7,88.66,17.32,ZZ-20170524-Cellfree-10-68,S68_B14,F8,424783,73,357256,84.10%,36618,2471,11144,7557,3587,11144,7557,3587,15931,Ductal,2,0,0,1,AC/T,14/02/2011,25/05/2011,1/3/25,N
C69,2065,2,87.36,17.07,ZZ-20170524-Cellfree-10-69,S69_B14,F9,480881,72,385644,80.20%,56354,5330,11291,7560,3731,11291,7560,3731,8/12/10,Ductal,2,1,1,1,TC,15/09/2010,29/12/2010,1/3/25,N
C70,2065,3,120.91,23.62,ZZ-20170524-Cellfree-10-70,S70_B14,F10,425241,74,372086,87.50%,29294,1557,10097,6784,3313,10097,6784,3313,23/03/2011,Ductal,2,1,1,1,TC,15/09/2010,29/12/2010,1/3/25,N
C71,2060,2,138.53,27.06,ZZ-20170524-Cellfree-10-71,S71_B14,F11,387124,74,336071,86.81%,24523,1071,10237,6960,3277,10237,6960,3277,13/10/2010,Ductal,2,0,0,1,AC/T,7/7/10,13/10/2010,1/3/25,N
C72,2060,3,167.75,32.77,ZZ-20170524-Cellfree-10-72,S72_B14,F12,415921,73,356130,85.62%,28771,1490,10706,7296,3410,10706,7296,3410,26/01/2011,Ductal,2,0,0,1,AC/T,7/7/10,13/10/2010,1/3/25,N
C73,2048,2,126.18,24.65,ZZ-20170524-Cellfree-10-73,S73_B14,G1,378837,74,325782,86.00%,26289,916,9526,6437,3089,9526,6437,3089,10/6/10,Ductal,2,1,1,0,AC/T,18/03/2010,24/06/2010,1/3/25,N
C74,2048,4,67.26,13.14,ZZ-20170524-Cellfree-10-74,S74_B14,G2,392676,75,345203,87.91%,24890,1577,9381,6466,2915,9381,6466,2915,21/03/2011,Ductal,2,1,1,0,AC/T,18/03/2010,24/06/2010,1/3/25,N
C75,2041,2,88.53,17.29,ZZ-20170524-Cellfree-10-75,S75_B14,G3,387720,75,341278,88.02%,23652,1375,9192,6261,2931,9192,6261,2931,24/02/2010,Ductal,2,0,0,0,TC,2/12/09,24/02/2010,1/3/25,N
C76,2041,3,39.15,7.65,ZZ-20170524-Cellfree-10-76,S76_B14,G4,337636,75,295828,87.62%,24007,2156,7138,4899,2239,7138,4899,2239,14/07/2010,Ductal,2,0,0,0,TC,2/12/09,24/02/2010,1/3/25,N
C77,2039,3,78.57,15.35,ZZ-20170524-Cellfree-10-77,S77_B14,G5,371756,75,326841,87.92%,23240,1033,8733,5952,2781,8733,5952,2781,8/4/10,Ductal,3,1,1,0,AC/T,29/10/2009,8/2/10,1/3/25,N
C78,2039,4,88.68,17.32,ZZ-20170524-Cellfree-10-78,S78_B14,G6,442472,73,376822,85.16%,36832,2945,10980,7351,3629,10980,7351,3629,25/10/2010,Ductal,3,1,1,0,AC/T,29/10/2009,8/2/10,1/3/25,N
C79,2038,2,93.28,18.22,ZZ-20170524-Cellfree-10-79,S79_B14,G7,344352,75,299577,87.00%,24914,1092,9236,6426,2810,9236,6426,2810,18/01/2010,Ductal,2,0,0,0,AC/T,26/10/2009,1/2/10,1/3/25,N
C80,2038,4,99.31,19.4,ZZ-20170524-Cellfree-10-80,S80_B14,G8,465766,73,387357,83.17%,44313,4184,11493,7949,3544,11493,7949,3544,24/01/2011,Ductal,2,0,0,0,AC/T,26/10/2009,1/2/10,1/3/25,N
C81,2031,2,9.54,1.86,ZZ-20170524-Cellfree-10-81,S81_B14,G9,379136,74,314778,83.03%,40389,3932,6337,4526,1811,6337,4526,1811,10/11/09,Ductal,2,1,1,0,TC,13/08/2009,14/10/2009,1/3/25,N
C82,2031,3,42.52,8.31,ZZ-20170524-Cellfree-10-82,S82_B14,G10,395949,75,338144,85.40%,33624,2369,9198,6358,2840,9198,6358,2840,26/03/2010,Ductal,2,1,1,0,TC,13/08/2009,14/10/2009,1/3/25,N
C83,2028,2,81.65,15.95,ZZ-20170524-Cellfree-10-83,S83_B14,G11,369065,74,301275,81.63%,44672,2047,9311,6364,2947,9311,6364,2947,23/09/2009,Ductal,2,1,0,0,TC,22/07/2009,23/09/2009,1/3/25,N
C84,2028,3,33.26,6.5,ZZ-20170524-Cellfree-10-84,S84_B14,G12,406225,74,351484,86.52%,29727,1780,10115,6895,3220,10115,6895,3220,5/4/10,Ductal,2,1,0,0,TC,22/07/2009,23/09/2009,1/3/25,N
C85,2024,2,101.79,19.88,ZZ-20170524-Cellfree-10-85,S85_B14,H1,410315,75,360503,87.86%,25193,1025,10018,6744,3274,10018,6744,3274,13/08/2009,Ductal,2,1,1,0,AC/T,21/05/2009,27/08/2009,1/3/25,N
C86,2024,4,37.17,7.26,ZZ-20170524-Cellfree-10-86,S86_B14,H2,338584,75,293922,86.81%,23685,2224,8504,6037,2467,8504,6037,2467,1/7/10,Ductal,2,1,1,0,AC/T,21/05/2009,27/08/2009,1/3/25,N
C87,2023,2,91.31,17.84,ZZ-20170524-Cellfree-10-87,S87_B14,H3,355887,75,314228,88.29%,20704,1261,9196,6346,2850,9196,6346,2850,12/8/09,Ductal,2,0,0,0,AC/T,27/05/2009,19/08/2009,1/3/25,N
C88,2023,5,124.36,24.29,ZZ-20170524-Cellfree-10-88,S88_B14,H4,358987,75,313604,87.36%,22537,1114,9929,6866,3063,9929,6866,3063,16/08/2010,Ductal,2,0,0,0,AC/T,27/05/2009,19/08/2009,1/3/25,N
C89,2014,3,51.16,9.99,ZZ-20170524-Cellfree-10-89,S89_B14,H5,405551,75,354944,87.52%,28568,2422,9278,6428,2850,9278,6428,2850,14/09/2009,Ductal,2,1,0,0,AC/T,26/02/2009,8/6/09,1/3/25,N
C90,2014,5,28.37,5.54,ZZ-20170524-Cellfree-10-90,S90_B14,H6,361720,74,298442,82.51%,43902,3658,7379,5125,2254,7379,5125,2254,14/07/2010,Ductal,2,1,0,0,AC/T,26/02/2009,8/6/09,1/3/25,N
C91,2005,2,33.39,6.52,ZZ-20170524-Cellfree-10-91,S91_B14,H7,345060,75,302250,87.59%,23199,2000,8119,5549,2570,8119,5549,2570,23/02/2009,Ductal,2,1,1,0,TC,12/11/08,14/01/2009,1/3/25,N
C92,2005,3,14.16,2.77,ZZ-20170524-Cellfree-10-92,S92_B14,H8,351558,74,297278,84.56%,35084,3414,7099,4869,2230,7099,4869,2230,3/6/09,Ductal,2,1,1,0,TC,12/11/08,14/01/2009,1/3/25,N
C93,2003,2,114.52,22.37,ZZ-20170524-Cellfree-10-93,S93_B14,H9,446446,75,397125,88.95%,23418,967,10322,6905,3417,10322,6905,3417,15/01/2009,Ductal,2,1,1,0,AC/T,24/10/2008,12/2/09,1/3/25,N
C94,2003,3,67.67,13.22,ZZ-20170524-Cellfree-10-94,S94_B14,H10,367318,75,324069,88.23%,22311,1341,8703,5903,2800,8703,5903,2800,2/7/09,Ductal,2,1,1,0,AC/T,24/10/2008,12/2/09,1/3/25,N
C95,2002,2,38.65,7.55,ZZ-20170524-Cellfree-10-95,S95_B14,H11,363729,75,319003,87.70%,23360,2196,8472,5758,2714,8472,5758,2714,22/12/2008,Ductal,3,1,1,1,AC/T,13/10/2008,19/01/2009,1/3/25,N
C96,2002,3,41.04,8.02,ZZ-20170524-Cellfree-10-96,S96_B14,H12,344473,75,302913,87.94%,21536,1386,7874,5319,2555,7874,5319,2555,15/04/2009,Ductal,3,1,1,1,AC/T,13/10/2008,19/01/2009,1/3/25,N